NO       ./xpms/walls/ressalhi1.xpm    
WE      ./xpms/walls/ressalhi3.xpm    
EA     ./xpms/walls/ressalhi4.xpm      

C     139  ,  69,  19                    
F  139 ,  5 ,  4 
SO      ./xpms/walls/ressalhi2.xpm   

                                      111
                                     10S01
        11111111111111111111          101           111111111111111111111111
    1111000000000000000000001111111111101111111111110000000000000000000001111111
11110000000000000000000000000000000000000000000000000000000000000000000000001111
    111100000000000000000000111111111100011111111111000000000000000000001111
        11111111111111111111          101           11111111111111111111
                101                   101                   101
                101                   111                   101
                101                   111                   101
             111101111                101                111101111
            10000000001               101               10000000001
             111101111                101                111101111
                101                   101                   101
                101                   101                   101
                101                   101                   101
                100111111111111111111110111111111111111111110011111111111111111111111111111111111111111111111111111111111111111111111111111111111111111
                1000000000000000000011100000000000000000000000000000000000000000000000000000000000000000000000000000000000000000000000000000000010000001
                111111111111111111111101111111111111111111111111111111111111111111111111111111111111111111111111111111111111111111111111111111111111111
                                      101
                                      101
                                      101
                                      101
                                     11011
                                    1000001
                                     11011
                                      101
                                      111
