NO  ./xpms/walls/ressalhi4.xpm 
SO  ./xpms/walls/ressalhi3.xpm
WE  ./xpms/walls/ressalhi2.xpm
EA  ./xpms/walls/ressalhi1.xpm
C 0,191,255
F 139,69,19





11111111111111
100E0000200001
10000000100001
11111000100001
     111100001111111
        100000000001
        100000000001
        110000000000111111111111111111
        111111110000002000000010000001 
                1111111000000010000001
              110000000000000020000001
    1111111111000000000000001111111111
    1000000001000000000000001
    1000000002000000000000001
    1000000001000000000000001
    1000000111111111111111211
    10000001 00000001 1110001
    100000001111111111 100001
    10000000000010001111110001
    12111111111110000000000001
    1001        11111111111001
    1001                  1121
    1001                111001   
    1001                100001
    1001                100001   111111111111111111111111111111111111111111111111
    1001                1000011110000000000000000001               10000000000001
    1001                100000020000000000000000000111111111111111100000000000001
    1001                100000010000000000000000000000000000000000000000000000001
    1001                111111111111111111111111111111111111111111111111111111111
    10001
    100001
    1110001
    10000001
1111100000001
1000100000001
1000100000001
1000111100001
1000000100001
1000000100001
1000000000001
1111112111111
1111110111111
1111110111111
1111112111111
1000000000001
1000001000001
1000001000001
1111111111111
