1111111111111111111111111111111111111111111111
1000000020000001000000100001000000000020000001
1000000010000001000000100001000000000010000001
1112111110000001000000100001000000000010000001
1000000010000001000000111121111111121111111111
1112111111111111000000000000000000000000000001
1100000000000001000000000000000000000000000001
1100000000000001000000121111111111111111111111
1111111111112111000000100002000000000010000001
1000000010000000000000100001000000000010000001
100000000000000000000P000000000000000000000001
1000000000000000000000100000000000000000000001
1000000000000000000000010000000000000000000001
1000000000000000000000000000000000000000000001
1000000000000000000000000000000000000000000001
1000000000000000000000000000000000000000000001
1000000000000000000000000000000000000000000001
1000000000000000000000000000000000000000000001
1000000000000000000000000000000000000000000001
1000000000000000000000000000000000000000000001
1000000000000000000000000000000000000000000001
1000000000000000000000000000000000000000000001
1000000000000000000000000000000000000000000001
1000000000000000000000000000000000000000000001
1000000000000000000000000000000000000000000001
1000000000000000000000000000000000000000000001
1000000000000000000000000000000000000000000001
1000000000000000000000000000000000000000000001
1000000000000000000000000000000000000000000001
1000000000000000000000000000000000000000000001
1000000000000000000000000000000000000000000001
1000000000000000000000000000000000000000000001
1000000000000000000000000000000000000000000001
1000000000000000000000000000000000000000000001
1000000000000000000000000000000000000000000001
1000000000000000000000000000000000000000000001
1000000000000000000000000000000000000000000001
1000000000000000000000000000000000000000000001
1000000000000000000000000000000000000000000001
1111111111111111111111111111111111111111111111