 NO ./xpms/ressalhi1.xpm

	SO 				./xpms/ressalhi2.xpm

WE 			./xpms/ressalhi3.xpm

EA ./xpms/ressalhi4.xpm
C 55, 55,  9 
F 10,10,   10


                                      111
                                     10001
        11111111111111111111          101           111111111111111111111111
    111100000000000000100000111111111110111111111111000000000000000000000111 111
11110000000000000W00010000000000000000000000000000000000000000000000000000001111
    111100000000000000000000111111111100011111111111000000000000000000001111
        11111111101111111111          101           11111111101111111111
                101                   101                   101
                101                   101                   101
                101                   101                   101
             111101111                101                111101111
            10000000001               101               10000000001
             111101111                101                111101111
                101                   101                   101
                101                   101                   101
                101                   101                   101
                100111111111111111111110111111111111111111110011111111111111111111111111111111111111111111111111111111111111111111111111111111111111111
                10000000000000000000111000000000000000000000000000000000000000000000000000000000000000000000000000000000000000000000000000000000100000011
                111111111111111111111101111111111111111111111111111111111111111111111111111111111111111111111111111111111111111111111111111111111111111
                                      101
                                      101
                                      101
                                      101
                                     11011
                                    1000001
                                     11011
                                      101
                                      111