NO ./xpms/ressalhi1.xpm
SO ./xpms/ressalhi2.xpm
WE ./xpms/ressalhi3.xpm
EA ./xpms/ressalhi4.xpm

C 0,191,255
F 139,69,19
                                                        11111111111111111111111111111111111111111111111
                                                       100000000000000000000000000000000000000000000011
      1111111111111111111111111111111111111111         1000000000000000000000000000000000000000000000011
 111111010000000000000000000000011    11111            10000000000000001000000000000000000000000000000011
 10000000000000000011110000000000111   11111111111     100000000000000000000000000000000000000000000000011
 1100000000000000001  10000000000001   11000000001     1000000000000000000000000000000000000000000000000011
 1111111111111111111  11111110111111   11111111101     10000000000000000000000000100000000000000000000000011
                           10001               101     10000000000S000000000000011100000000000000000000000011
 11111111111111111     111110001111111111111   101111  1000000000000000000000001111100000000000000000000000011
 11000000000000011    1100000000000000000001   100001  10000000000000000000000111 11100000000000000000000000011
 10000000000000001    1000000000000000000001   1100011 1000000000000000000000111   11100000000000000000000000011111
 11000000000000011    1100000000000111110001   1000001 10000000000000000000000111 11100000000000000000000000011
 1000000000000001      1000000000001   10001   1000001 1000000000000000000000001111100000000000000000000000011
 11100000000000011111111000000000001   10001   11000011100000000000000000000000011100000000000000000000000011
  1111000000000000001000000000000001   10001  11100000000000000000000000000000000100000000000000000000000011
  1100000000000000000000000001111111   11111  1000111111000000000000000000000000000000000000000000000000011
  11111000001100000000000000000001            10001    100000000000001000000000000000000000000000000000011
111000000000000000000000000001111111111111111110001    1000000000000010000000000110000000000000000000001
111111000000000000000000000000000000000000000000001    1000000000000010000000001000000000000000000000011
    11111100000000000000000011111111111111111000001    100000000000001000000000000000000000000000000011
        1111110000000000111111            111111111    10000000000000000000000000000000000000000000011
            11111111001111111111                       1000000000000000000000000000000000000000000011
                  110011                        11111111111111110111111111111111111111111111111111111
11111111111111111111001111111111111111111111111110000000000000000111111111111111111111111111111111
1111111111111111111100111111111111111111111111111000000111111111111111111111111111111111111111111111111
                  110011                     111100000011
                  110011                     100000000011
                  110011                     100111100011
                  110011                     1001  100011
             11111110011111111111111111111111100111100011111111111111111111111111
             10000000000000000000000000000000000000000000000000000000000011
             10000000000000000000011111111111111111000000000000000000000011
             1111100000000000000001     111      1000000000000000000000011
                 100000000000000001              11000000111111111111111111
    11111111111111000000000000001111111111111111110000011
    110000000000000000000000000000000000000000000000000011       11111111111111111
    110000000000000000000000000000000000000000000000000011       10000000000000001
    110000000000000000000000000000000000000000000000000011111111110000000000000001
    110000000000000000000000000000000000000000000000000000000000000000000000000001
    110000000000000000000000000000000000000000000000000000000000000000000000000001
    110000000000000000000000000000000000000000000000000011111111110000000000000001
    110000000000000000000000000000000000000000000000000011       1000000000000000111111111
    110000000000000000000000000000000000000000000000000011       1000000000000000000000001
    110000000000000000000000000000000000000000000000000011   11111000000000000000000000001
    110000000000000000000000000000000000000000000000000011   10000000000000000000000000001
    110000000000000000000000000000000000000000000000000011   10000000000000000000000000001
    110000000000000000000000000000000000000000000000000011   11111111111111111111111111111
    11111111111111111111111111111111111111111111111111111
