NO ./xpms/ressalhi1.xpm
SO ./xpms/ressalhi2.xpm
WE ./xpms/ressalhi3.xpm
EA ./xpms/ressalhi4.xpm

C 55, 55,  9 
F 10,10,   10

1111111
1000001
1111101
111111111111111111111111111
1111111111111111111111111	
100000000000000000000011
 1000000000000000000001
  100000000N0000000001
   100000011000000001
    1000010010000001
     10000110000001
      1000000000101
       10000000011
        10000001
         101101
          1001
           11
