NO ./xpms/ressalhi1.xpm
SO ./xpms/ressalhi2.xpm
WE ./xpms/ressalhi3.xpm
EA ./xpms/ressalhi4.xpm

F 55, 55, 55
C 100,100,100


11111111111111111111111
100000000000S00000000001
 1000000000000000000001
  10000000000000000001
   100000011000000001
    1000010010000001
     10000110000001
      1000000000101
       10000000011
        10000001
         101101
          1001
           11