NO ./xpms/ressalhi1.xpm
SO ./xpms/ressalhi2.xpm
WE ./xpms/ressalhi3.xpm
EA ./xpms/ressalhi4.xpm      

F 55, 55, 55
C 100	,   100,   100 		


1111111111111111111111111111111111111111111111
1000000010000001000000100001000000000010000001
1000000010000001000000100001000000000010000001
1111111110000001000000100001000000000010000001
1000000010000001000000111111111111111111111111
1111111111111111000000000000000000000000000001
1100000000000001000000000000000000000000000001
1100000000000001000000111111111111111111111111
1111111111111111000000100001000000000010000001
1000000010000000000010100001000000000010000001
100000000000000000001N000000000000000000000001
1000000000000000000011100000000000000000000001
1000000000000000000000010000000100000000000001
1000000000000000000000000000000000000000000001
1111111111111111111111111111111111111111111111