NO 		./xpms/ressalhi1.xpm
SO 		 ./xpms/ressalhi2.xpm
WE  	 ./xpms/ressalhi3.xpm
EA          ./xpms/ressalhi4.xpm
F 10,10,10
C 255,255,255
        1111111111111111111111111
        1000000000110000000000001
        111100000111000N000000001
        1001000000000000000000001
111111111011000001110000000000001
100000000011000001110111111111111
11110111111111011100000010001
11110111111111011101010010001
11000000110101011100000010001
1000000000000000110000001000011
10000000000000001101010000001
110000011101010111110111000111
11110111 1110101 101111010001
11111111 1111111 111111111111