NO 		./xpms/ressalhi1.xpm
SO 		 ./xpms/ressalhi2.xpm
C 255, 255,255
WE  	 ./xpms/ressalhi3.xpm
EA          ./xpms/ressalhi4.xpm
F  0 , 0 ,, 0 
 1111111111111111111111
100000000000S00000000001
 1000000000000000000001
  10000000000000000001
   100000011000000001
    100001 010000001
     10000110000001
      100000000001
       1000000001
        10000001
         101101
          1001
           11