NO 		./xpms/ressalhi1.xpm
SO 		 ./xpms/ressalhi2.xpm
WE  	 ./xpms/ressalhi3.xpm
EA          ./xpms/ressalhi4.xpm
F 255,0,200
C 255,255,255

1111111111111111111111111
1000000000110000000000001
1011000001110000000000001
1001000000000000000000001
1111111110110000011100001
1000000000110000011101111
1111011111111101110000001
1111011111111101110101001
110N000011010101110000001
1000000000000000110000001
1000000000000000110101001
1100000111010101111101111
11110111 1110101 10111101
11111111 1111111 11111111