NO        ./textures/hjrifi.xpm      
SO  ./textures/hjrifi.xpm
WE  ./textures/wood.xpm
EA  ./textures/redbrick.xpm
C   10,10,10
F    160,160,160





11111111111111
10000000200001
10000000100001
11111000100001
     111100001111111
        100000000001
        100000400001
        110000000000111111111111111111
        111111110000002000000010000001 
                1111111000000010044001
              110000000000000020000001
    1111111111000044400000001111111111
    1400000001000044400000001
    1000000002000000000000001
    1000000001000000000000001
    1000000111111111111111211
    10000001            10001
    1000000011111111   100001
    10000000000414001111110001
    12111111111110000000000001
    1001        11111111111001
    1001                  1121
    1001                111001   
    1001                100001
    1001                100001   111111111111111111111111111111111111111111111111
    1001                100001111444444444444444444444444444444444444444444444441
    1001                100000020000000000000000000000000000000000000000000000001
    1001                140000010444444444444444444444444444444444444444444444441
    1001                111111111111111111111111111111111111111111111111111111111
    10001
    100001
    1110001
    10000001
1111100000001
1000100000001
1040100000001
1000111100001
1000000100001
1000000100001
1000000000001
1111112111111
1111110111111
111111S111111
1111112111111
1000000000001
1000001000001
1400001000041
1111111111111
