NO  ./xpms/walls/ressalhi1.xpm      
SO  ./xpms/walls/ressalhi2.xpm
WE  ./xpms/walls/ressalhi3.xpm
EA  ./xpms/walls/ressalhi4.xpm
C 0,191,255
F 139,69,19

1111111111111111111111111111111111111111111111
1000000010000001000000100001000000000010000001
1000000010000001000000100001000000000010000001
1111111110000001000000100001000000000010000001
1000000010000001110000111111111111111111111111
1111111111111111000000000000000000000000000001
1100000000000001110000000000000000000000000001
1100000000000001000000111111111111111111111111
1111111111111211000000100001000000000010000001
1000000010000000000000100001000000000010000001
10000000000000S0000000000000000000000000000001
1000000004000000000000100000000000000000000001
1000000000000000000000010000000000000000000001
1000000000000000000000000000000000000000000001
1000000000000000000000000000000000000000000001
1111111111111111111111111111111111111111111111