NO ./textures/greystone.xpm      
SO ./textures/wood.xpm
WE ./textures/hjrifi.xpm
EA ./textures/redbrick.xpm

F  0,0,0
C  255,214,114

1111111111111111111111111111111111111111111111
1000000010000001S00000100001000000000010000001
1000000010000001000000100001000000000010000001
1111111110000001000000100001000000000010000001
1000000010000001110000111111111111111111111111
1111111111111111000000000000000000000000000001
1100000000000001110000000000000000000000000001
1100000000000001000000111111111111111111111111
1111111111111111000000100001000000000010000001
1000000010000000000000100001000000000010000001
1000000000000000000000000000000000000000000001
1000000000000000000000100000000000000000000001
1000000000000000000000010000000000000000000001
1000000000000000000000000000000000000000000001
1111111111111111111111111111111111111111111111