NO ./textures/greystone.xpm      
SO ./textures/wood.xpm
WE ./textures/hjrifi.xpm
EA ./textures/redbrick.xpm

C  0,0,0
F  124,214,114

1111111111111111111111111111111111111111111111
100000001000000100000E100001000000000010000001
1000000010000001000000100001000000000010000001
1111111110000001000000100001000000000010000001
1000000010000001110000111111111111111111111111
1111111111111111010000000000000000000000000001
1100000000000001110000000000000000000000000001
1100000000000001000000111111111111111111111111
1111111111111111000000100001000000000010000001
1000000010000000000000100001000000000010000001
1000000000000000000000000000000000000000000001
1000000000000000000000100000000000000000000001
1000000000000000000000010000000000000000000001
1000000000000000000000000000000000000000000001
1111111111111111111111111111111111111111111111