NO  ./xpms/walls/ressalhi1.xpm      
SO  ./xpms/walls/ressalhi2.xpm
WE  ./xpms/walls/ressalhi3.xpm
EA  ./xpms/walls/ressalhi4.xpm
C 0,191,255
F 139,69,19

111111111
100000001
100000001
100000001
100000001
1000000N1
111111111
