NO  ./xpms/walls/ressalhi1.xpm      
SO  ./xpms/walls/ressalhi2.xpm
WE  ./xpms/walls/ressalhi3.xpm
EA  ./xpms/walls/ressalhi4.xpm
C 0,191,255
F 139,69,19


111111
1 0111
111111
101111
1N1111
111111
