NO  ./xpms/walls/ressalhi1.xpm
SO  ./xpms/walls/ressalhi2.xpm
WE  ./xpms/walls/ressalhi3.xpm
EA  ./xpms/walls/ressalhi4.xpm

F  0,0,0
C  255,214,114

111111111
100000001
100040001
100000001
100000001
1000000N1
111111111
